

000111111111111111111111111111111111111111111111111111111111111111111111111111111111111111111111111111111111111111111
000000000000000500001000000000100000000000000000010000000001400000000000000000000000010000000001000000000100000000031
000111111111111100001000011111111111000011111000011111100001111111100001111111111111110000100001000010000100000000001
000100000000000000001000010000000000000000001000000000000001000000000001000000000000000000100001000010000100001111111
000111111111111100001000010000000000000000001000000000000001000000000001000000000000000000100001000010000000000000001
000100000000000100001000010000111111111100001000011111111111000000111111111111111000011111100001000011111111111111111
000100000000000100001000010000100000000000001000000000100001000000000001000000000000010000100001000010000000000000001
000100001111111100001000010000111110000111111000010000100001111111100001000011111000010000111111000010000111111100001
000100001000000000000000010000000010000100000000010000100001000000000000000010001000010000000000000000000100000000001
000100001000000000000000010000000010000100000000010000100001000000000000000010001000010000000000000000000100000000001
000100001000011111111111111111000010000100001000011111100001000011111111111110001000010000111111111110000100000111111
000100000000000000000000000001000010000100001000010000000000000000000010000000001000010000000001000010000100000000001
000100000000000000000000000001000010003100001000010000000000000000000013000000001000010000000001000010000100000000001
000111111000011111110000100001000011111100001111110000111111000010000011111110001000011111100001000010000111111100001
000100001000000000010000100001000000000100000000010000100001000010000010000010000000000000100001000010000100000100001
000100001000000000010000100001000000000100000000010000100001000010000010000010000000000000100001000010000100000100001
000100001111111111110000111111000010000111111000011111100001111110000010000010001111110000111111000010000100000100001
000100001000000000000000100000000010000000001000013000000001000000000010000010000000010000000001000000000000000100001
000100001000010000011111100001111110000111111000010000111111000011111110000011111000011111100001000011111100000111111
000100000000010000010000100000000010000100000000010000000001000000000010000000001000010000100001000010000100000000001
000111111111110000010000111111000011111100001111111111100001000000000010000000001000010000100001000010000111111100001
000100000000000000010000000000000010000000000000000000000001000010000010000010000000000000100001000000000000000100001
000100001111111111111111100001000010000111111000011111111111111110000010000010000000000000100001000000000000000100001
000100000000000000000000100001000010000000001000000000000000000000000011111111111111110000100001000011111111111100001
000100000000000000000000100001000010000000001000000000000000000000000010000000000000010000100001000000000000000100001
000111111111110000010000111111000011111100001000011111111111111111000010000010001111110000111111000010000111111100001
000130000000000000010000000000000010000000001000000000000001000000000000000010000000010000000000000010000140000000009
000111111111111111111111111111111111111111111111111111111111111111111111111111111111111111111111111111111111111111111